
Словарь терминов, переводов мест и имен, а также спорных моментов:
-------------
Бёрч - Burch
Боб Нил - Bob Neil
Плесень - Мold
Зудила - Itchie
Мормон Патрик - Patrick the Mormon
Форсажник - Furius? Furiouser? Furymaker? //что-то надо решить
Страйкер (персонаж) - Stryker
Страйкер (пушка) - Striker
Доктор Вилмут - dr. Willmouth
Дилижанс - Carriage
Большой Луи - Big Louie
Скоростной Ястреб – Hawk Express
Пугач – Liberator
Поджиг – Zipper (deprecated)
Ветер Войны – Wind of War
Хозяин - The Boss
Гэри Гилмор - Gary Gilmore
Солт-Лейк - Salt Lake City
Beiyang Military Medical Center - Бэйянский военно-медицинский центр
Чистые Души - Pure Souls
Лавлок - Lovelock
Шайенн - Cheyenne
Джексон - Jackson
Джесси - Jesse
Динамитная шашка - Dynamite stick
Гэрри - Garry
Прово - Provo
Микки - Mickey
Матка - Queen
Шпилька - bobby pin
Рябой - Freckles
Хоторн - Hawthorne
Родж - Rogie // сокращенно от Roger? Как это вообще сократить?
Жирюга - Fatso
антикурильщик - anti-smoker
обезболивающее - painkillers
червь - ringworm
Караванщик - caravan merchant
Металлоискатель - metal detector
Андерс - Anders
Зона 51 - Area 51
Город убежища - Vault City
Убежище 8 - Vault 8
Община блэк-Рок - Black-Rock
Ветер Войны - Wind of War
Питомник - The Kennel
АЭС Посейдон Ойл - Poseidon Oil NPP
Община Джерлака - Jerlac's community
Джерлак - Jerlac
Дамба гувера - Hoover Dam
Лас-Вегас - Las Vegas
район Прово - Provo
Баттл-маунтин - Battle Mountain
Западный уэндовер - West Wendover
Нью-Рино - New Reno
Солт-лейк-сити - Salt Lake City
Уран Сити - Uranium City
Убежище 15 - Vault 15
Спад - Spud
Ультратермит - Ultrathermite
Нюка-Кола - Nuka-Cola // capital letters everywhere!
Гижияш - Gizhiyash
Нискигван - Niskigvan
Аванигижиг Туманный День - Avanigizhig Foggy Day
